MMI屏黑屏=MMI屏黑屏
离站倒计时显示=离站倒计时显示
请求制动=请求制动
触发紧急制动=触发紧急制动
车辆正在牵引=车辆正在牵引
车辆为惰行=车辆为惰行
车辆正在制动=车辆正在制动
最高模式RM=最高模式RM
最高模式SM_I=最高模式SM-I
最高模式SM_C=最高模式SM-C
最高模式AM_I=最高模式AM-I
最高模式AM_C=最高模式AM-C
列车失去完整性=列车失去完整性
制动缸压力不正常=制动缸压力不正常
车首OBCU激活车尾OBCU待机=车首OBCU激活，车尾OBCU待机
车首OBCU激活车尾OBCU关闭或故障=车首OBCU激活，车尾OBCU关闭或故障
车首OBCU关闭车尾OBCU激活=车首OBCU关闭，车尾OBCU激活
AM模式=AM模式
SM模式=SM模式
RM模式=RM模式
ATC切除=ATC切除
IXL等级=IXL等级
ITC等级=ITC等级
CTC等级=CTC等级
ARoffered=AR offered
ARactive=AR active
DTROisoffered=DTRO is offered
DTROactive=DTRO active
在停车范围=在停车范围
超出停车范围=超出停车范围
左侧车门打开=左侧车门打开
右侧车门打开=右侧车门打开
两侧车门同时打开=两侧车门同时打开
先开左门=先开左门
先开右门=先开右门
不再监控车门=不再监控车门
允许释放车门=允许释放车门
关闭门命令=关闭门命令
要求离站=要求离站
扣车=扣车
跳停=跳停
车门手动打开手动关闭=车门手动打开/手动关闭
车门自动打开手动关闭=车门自动打开/手动关闭
车门自动打开自动关闭=车门自动打开/自动关闭
车辆施加EB=车辆施加EB
车辆空转打滑=车辆空转打滑
PSD未关闭=PSD未关闭
ATP故障=ATP故障
ATO故障=ATO故障
无线通信中断=无线通信中断
进入车辆段=进入车辆段
在车辆段内行驶=在车辆段内行驶
释放速度=释放速度
按钮干扰=按钮干扰
按钮回复中=按钮回复中
警惕旁路=警惕旁路
停放制动缓解旁路=停放制动缓解旁路
所有制动缓解旁路=所有制动缓解旁路
总风压力可用旁路=总风压力可用旁路
ATC旁路=ATC旁路
门零速旁路=门零速旁路
门关好旁路=门关好旁路
车钩监视旁路=车钩监视旁路
BHB切除=BHB切除
ATCZVRD监控=ATC ZVRD监控
门能使旁路=门能使旁路
