InBMMI屏黑屏=MMI屏黑屏
InB离站倒计时显示=离站倒计时显示
InB请求制动=请求制动
InB触发紧急制动=触发紧急制动
InB车辆正在牵引=车辆正在牵引
InB车辆为惰行=车辆为惰行
InB车辆正在制动=车辆正在制动
InB强制ATO后备模式=强制ATO后备模式
InBATOCBTC模式=ATOCBTC模式
InB退行=退行
InBATC状态部分故障=ATC状态部分故障
InBATC状态正常=ATC状态正常
InBATC状态完全故障=ATC状态完全故障
InB车辆制动力降低=车辆制动力降低
InB当前司机室未激活=当前司机室未激活
InB当前司机室激活=当前司机室激活
InB当前司机室旁路=当前司机室旁路
InB远端司机室未激活=远端司机室未激活
InB远端司机室激活=远端司机室激活
InB远端司机室旁路=远端司机室旁路
InBATO模式=ATO模式
InBATP模式=ATP模式
InBRM模式=RM模式
InBATC切除=ATC切除
InBRMR模式=RMR模式
InBCBI已选择RM驾驶模式=CBI已选择RM驾驶模式
InBBM=BM
InBCBTC=CBTC
InB列车在ATB区域内=列车在ATB区域内
InB列车在正进行ATB折返=列车在正进行ATB折返
InB列车正确停在停车点=列车正确停在停车点
InB列车未停到位=列车未停到位
InB左侧车门打开=左侧车门打开
InB右侧车门打开=右侧车门打开
InB两侧车门打开=两侧车门打开
InBATC没有授权情况下车门打开=ATC没有授权情况下车门打开
InB请求车门关闭=请求车门关闭
InBATC请求列车离站=ATC请求列车离站
InB车门手动打开手动关闭=车门手动打开手动关闭
InB车门自动打开手动关闭=车门自动打开手动关闭
InB车门自动打开自动关闭=车门自动打开自动关闭
InB车辆施加EB=车辆施加EB
InB车辆空转打滑信息正常范围=车辆空转打滑信息正常范围
InB车辆空转打滑信息严重=车辆空转打滑信息严重
InBPSD未关闭=PSD未关闭
InBPSD状态未知=PSD状态未知
InB无线通信中断=无线通信中断
InB选择了RM模式且ATC未定位=选择了RM模式且ATC未定位
InB提示是否强制选择BM模式=提示是否强制选择BM模式
InBATP进站显示目标距离显示距离=ATP进站显示目标距离显示距离
InB扣车=扣车
InB跳停=跳停
InB列车即将离开ATC区域=列车即将离开ATC区域
InBATOBM闪烁=ATOBM闪烁
InB车门无允许 =车门无允许 
InB左侧车门允许=左侧车门允许
InB右侧车门允许=右侧车门允许
InB两侧车门允许=两侧车门允许
InB允许手动方式开左门且左右门均关好=允许手动方式开左门且左右门均关好
InB允许手动方式开左门且车门未关闭=允许手动方式开左门且车门未关闭
InB允许手动方式开右门且左右门均关好=允许手动方式开右门且左右门均关好
InB允许手动方式开右门且车门未关闭=允许手动方式开右门且车门未关闭
InB允许手动方式开两侧门且左右门均关好=允许手动方式开两侧门且左右门均关好
InB允许手动方式开两侧门且车门未关闭=允许手动方式开两侧门且车门未关闭
InB允许手动方式先开左门后开右门且左右门均关好=允许手动方式先开左门后开右门且左右门均关好
InB允许手动方式先开左门后开右门且车门未关闭=允许手动方式先开左门后开右门且车门未关闭
InB允许手动方式先开右门后开左门且左右门均关好=允许手动方式先开右门后开左门且左右门均关好
InB允许手动方式先开右门后开左门且车门未关闭=允许手动方式先开右门后开左门且车门未关闭
InB允许自动方式开左门且左右门均关好=允许自动方式开左门且左右门均关好
InB允许自动方式开左门且车门未关闭=允许自动方式开左门且车门未关闭
InB允许自动方式开右门且左右门均关好=允许自动方式开右门且左右门均关好
InB允许自动方式开右门且车门未关闭=允许自动方式开右门且车门未关闭
InB允许自动方式开两侧门且左右门均关好=允许自动方式开两侧门且左右门均关好
InB允许自动方式开两侧门且车门未关闭=允许自动方式开两侧门且车门未关闭
InB允许自动方式先开左门后开右门且左右门均关好=允许自动方式先开左门后开右门且左右门均关好
InB允许自动方式先开左门后开右门且车门未关闭=允许自动方式先开左门后开右门且车门未关闭
InB允许自动方式先开右门后开左门且左右门均关好=允许自动方式先开右门后开左门且左右门均关好
InB允许自动方式先开右门后开左门且车门未关闭=允许自动方式先开右门后开左门且车门未关闭
InB信号屏是否显示目标距离=信号屏是否显示目标距离
InB信号屏是否显示目标速度=信号屏是否显示目标速度
InB信号屏是否显示当前速度以及速度指针=信号屏是否显示当前速度以及速度指针
InB信号屏是否显示允许速度=信号屏是否显示允许速度
InB信号屏是否显示推荐速度=信号屏是否显示推荐速度
InB预选模式闪烁=预选模式闪烁
InB最高模式RM=最高模式RM
InB最高模式SMI=最高模式SMI
InB最高模式SMC=最高模式SMC
InB最高模式AMI=最高模式AMI
InB最高模式AMC=最高模式AMC
InBARoffered显示人工折返图标=ARoffered显示人工折返图标
InBARactive人工折返图标激活=ARactive人工折返图标激活
InBDTROisoffered显示自动折返图标=DTROisoffered显示自动折返图标
InBDTROactive无人折返操作激活=DTROactive无人折返操作激活
InB列车完整性=列车完整性
InB先开左门=先开左门
InB先开右门=先开右门
InB不再监控车门=不再监控车门
InB允许释放车门=允许释放车门
InB关闭门命令=关闭门命令
InBATP故障=ATP故障
InBATO故障=ATO故障
InB进入车辆段=进入车辆段
InB在车辆段内行驶=在车辆段内行驶
InB释放速度=释放速度
InB目标距离刻度条红色=目标距离刻度条红色
InB目标距离刻度条黄色=目标距离刻度条黄色
InB目标距离刻度条淡绿色=目标距离刻度条淡绿色
InB进入屏保界面=进入屏保界面
InB菜单点击无反应=菜单点击无反应
InB要求进入RM模式 =要求进入RM模式 
InB确认释放速度以低速接近=确认释放速度以低速接近
InB由于离开TGMT区域切换到RM模式=由于离开TGMT区域切换到RM模式
InB确认模式级别的预选择=确认模式级别的预选择
InB激活确认按钮=激活确认按钮
InB激活ATO解锁触点=激活ATO解锁触点
InB激活ATO启动按钮=激活ATO启动按钮
InB激活自动折返按钮=激活自动折返按钮
InB激活操作模式降按钮=激活操作模式降按钮
InB激活操作模式升按钮=激活操作模式升按钮
InB激活门允许按钮=激活门允许按钮
InB按钮恢复失败=按钮恢复失败
InB按钮恢复拒绝=按钮恢复拒绝
InB按钮恢复成功=按钮恢复成功
InB