MMI屏黑屏=MMI屏黑屏
离站倒计时显示=离站倒计时显示
请求制动=请求制动
触发紧急制动=触发紧急制动
车辆正在牵引=车辆正在牵引
车辆为惰行=车辆为惰行
车辆正在制动=车辆正在制动
强制ATO后备模式=强制ATO后备模式
ATOCBTC模式=ATOCBTC模式
退行=退行
ATC状态部分故障=ATC状态部分故障
ATC状态正常=ATC状态正常
ATC状态完全故障=ATC状态完全故障
车辆制动力降低=车辆制动力降低
当前司机室未激活=当前司机室未激活
当前司机室激活=当前司机室激活
当前司机室旁路=当前司机室旁路
远端司机室未激活=远端司机室未激活
远端司机室激活=远端司机室激活
远端司机室旁路=远端司机室旁路
ATO模式=ATO模式
ATP模式=ATP模式
RM模式=RM模式
ATC切除=ATC切除
RMR模式=RMR模式
CBI已选择RM驾驶模式=CBI已选择RM驾驶模式
BM=BM
CBTC=CBTC
列车在ATB区域内=列车在ATB区域内
列车在正进行ATB折返=列车在正进行ATB折返
列车正确停在停车点=列车正确停在停车点
列车未停到位=列车未停到位
左侧车门打开=左侧车门打开
右侧车门打开=右侧车门打开
两侧车门打开=两侧车门打开
ATC没有授权情况下车门打开=ATC没有授权情况下车门打开
请求车门关闭=请求车门关闭
ATC请求列车离站=ATC请求列车离站
车门手动打开手动关闭=车门手动打开手动关闭
车门自动打开手动关闭=车门自动打开手动关闭
车门自动打开自动关闭=车门自动打开自动关闭
车辆施加EB=车辆施加EB
车辆空转打滑信息正常范围=车辆空转打滑信息正常范围
车辆空转打滑信息严重=车辆空转打滑信息严重
PSD未关闭=PSD未关闭
PSD状态未知=PSD状态未知
无线通信中断=无线通信中断
选择了RM模式且ATC未定位=选择了RM模式且ATC未定位
提示是否强制选择BM模式=提示是否强制选择BM模式
ATP进站显示目标距离显示距离=ATP进站显示目标距离显示距离
扣车=扣车
跳停=跳停
列车即将离开ATC区域=列车即将离开ATC区域
ATOBM闪烁=ATOBM闪烁
车门无允许 =车门无允许 
左侧车门允许=左侧车门允许
右侧车门允许=右侧车门允许
两侧车门允许=两侧车门允许
允许手动方式开左门且左右门均关好=允许手动方式开左门且左右门均关好
允许手动方式开左门且车门未关闭=允许手动方式开左门且车门未关闭
允许手动方式开右门且左右门均关好=允许手动方式开右门且左右门均关好
允许手动方式开右门且车门未关闭=允许手动方式开右门且车门未关闭
允许手动方式开两侧门且左右门均关好=允许手动方式开两侧门且左右门均关好
允许手动方式开两侧门且车门未关闭=允许手动方式开两侧门且车门未关闭
允许手动方式先开左门后开右门且左右门均关好=允许手动方式先开左门后开右门且左右门均关好
允许手动方式先开左门后开右门且车门未关闭=允许手动方式先开左门后开右门且车门未关闭
允许手动方式先开右门后开左门且左右门均关好=允许手动方式先开右门后开左门且左右门均关好
允许手动方式先开右门后开左门且车门未关闭=允许手动方式先开右门后开左门且车门未关闭
允许自动方式开左门且左右门均关好=允许自动方式开左门且左右门均关好
允许自动方式开左门且车门未关闭=允许自动方式开左门且车门未关闭
允许自动方式开右门且左右门均关好=允许自动方式开右门且左右门均关好
允许自动方式开右门且车门未关闭=允许自动方式开右门且车门未关闭
允许自动方式开两侧门且左右门均关好=允许自动方式开两侧门且左右门均关好
允许自动方式开两侧门且车门未关闭=允许自动方式开两侧门且车门未关闭
允许自动方式先开左门后开右门且左右门均关好=允许自动方式先开左门后开右门且左右门均关好
允许自动方式先开左门后开右门且车门未关闭=允许自动方式先开左门后开右门且车门未关闭
允许自动方式先开右门后开左门且左右门均关好=允许自动方式先开右门后开左门且左右门均关好
允许自动方式先开右门后开左门且车门未关闭=允许自动方式先开右门后开左门且车门未关闭
信号屏是否显示目标距离=信号屏是否显示目标距离
信号屏是否显示目标速度=信号屏是否显示目标速度
信号屏是否显示当前速度以及速度指针=信号屏是否显示当前速度以及速度指针
信号屏是否显示允许速度=信号屏是否显示允许速度
信号屏是否显示推荐速度=信号屏是否显示推荐速度
预选模式闪烁=预选模式闪烁
最高模式RM=最高模式RM
最高模式SMI=最高模式SMI
最高模式SMC=最高模式SMC
最高模式AMI=最高模式AMI
最高模式AMC=最高模式AMC
ARoffered显示人工折返图标=ARoffered显示人工折返图标
ARactive人工折返图标激活=ARactive人工折返图标激活
DTROisoffered显示自动折返图标=DTROisoffered显示自动折返图标
DTROactive无人折返操作激活=DTROactive无人折返操作激活
列车完整性=列车完整性
先开左门=先开左门
先开右门=先开右门
不再监控车门=不再监控车门
允许释放车门=允许释放车门
关闭门命令=关闭门命令
ATP故障=ATP故障
ATO故障=ATO故障
进入车辆段=进入车辆段
在车辆段内行驶=在车辆段内行驶
释放速度=释放速度
目标距离刻度条红色=目标距离刻度条红色
目标距离刻度条黄色=目标距离刻度条黄色
目标距离刻度条淡绿色=目标距离刻度条淡绿色
进入屏保界面=进入屏保界面
菜单点击无反应=菜单点击无反应
要求进入RM模式 =要求进入RM模式 
确认释放速度以低速接近=确认释放速度以低速接近
由于离开TGMT区域切换到RM模式=由于离开TGMT区域切换到RM模式
确认模式级别的预选择=确认模式级别的预选择
激活确认按钮=激活确认按钮
激活ATO解锁触点=激活ATO解锁触点
激活ATO启动按钮=激活ATO启动按钮
激活自动折返按钮=激活自动折返按钮
激活操作模式降按钮=激活操作模式降按钮
激活操作模式升按钮=激活操作模式升按钮
激活门允许按钮=激活门允许按钮
按钮恢复失败=按钮恢复失败
按钮恢复拒绝=按钮恢复拒绝
按钮恢复成功=按钮恢复成功
