InF主电压=主电压
InF主电流=主电流
InF滑油压力=滑油压力
InF燃油压力=燃油压力
InF冷却水温=冷却水温
InF机油温度=机油温度
InF机车速度=机车速度
InF柴油机转速=柴油机转速
InF1D电流=1D电流
InF2D电流=2D电流
InF3D电流=3D电流
InF4D电流=4D电流
InF5D电流=5D电流
InF6D电流=6D电流
InF电机电流差=电机电流差
InF电流分配系数=电流分配系数
InF1D转速=1D转速
InF2D转速=2D转速
InF3D转速=3D转速
InF4D转速=4D转速
InF5D转速=5D转速
InF6D转速=6D转速
InF电机转速差=电机转速差
InF柴油机高温水系统进口温度=柴油机高温水系统--进口温度
InF柴油机高温水系统出口温度=柴油机高温水系统--出口温度
InF柴油机冷水系统进口温度=柴油机冷水系统--进口温度
InF柴油机冷水系统出口温度=柴油机冷水系统--出口温度
InF柴油机冷水系统机油进口温度=柴油机冷水系统--机油进口温度
InF柴油机冷水系统机油出口温度=柴油机冷水系统--机油出口温度
InF柴油机冷水系统热交换器水温=柴油机冷水系统--热交换器水温
InF机油压力柴油机进口=机油压力--柴油机进口
InF机油压力柴油机出口=机油压力--柴油机出口
InF机油压力前增压器进口=机油压力--前增压器进口
InF机油压力后增压器进口=机油压力--后增压器进口
InF机油压力滤清器进口=机油压力--滤清器进口
InF燃油压力燃油泵出口=燃油压力--燃油泵出口
InF燃油压力系统末端=燃油压力--系统末端
InF1冷却风扇转速=#1冷却风扇转速
InF2冷却风扇转速=#2冷却风扇转速
InF励磁机励磁电流=励磁机励磁电流
InF励磁机励磁电压=励磁机励磁电压
InF接地漏电流=接地漏电流
InF主发电机励磁电流=主发电机励磁电流
InF电流传感器正电源=电流传感器正电源
InF电流传感器负电源=电流传感器负电源
InF前增压器转速=前增压器转速
InF后增压器转速=后增压器转速
InF海拔高度=海拔高度
InF经度=经度
InF纬度=纬度
InF水平速度=水平速度
InF机车累计运行里程=机车累计运行里程
InF机车累计带载运行时间=机车累计带载运行时间
InF主发功率基准=主发功率基准
InF牵引工况耗能=牵引工况耗能
InF电阻制动耗能=电阻制动耗能
InF主手柄位置lcp=主手柄位置/lcp
InF正24V电压=正24V电压
InF负24V电压=负24V电压
InF气表屏总风缸=气表屏--总风缸
InF气表屏列车管=气表屏--列车管
InF气表屏制动缸=气表屏--制动缸
InF气表屏均衡缸=气表屏--均衡缸
InF备用1=备用--1
InF备用2=备用--2
InF以下为重联屏接口=以下为重联屏接口
InF本车本车主电流表=本车本车主电流表
InF本车本车控制电压=本车本车控制电压
InF本车本车柴转速=本车本车柴转速
InF本车本车主电压=本车本车主电压
InF本车本车主电流=本车本车主电流
InF本车本车功率=本车本车功率
InF本车本车TM1电流=本车本车TM1电流
InF本车本车TM2电流=本车本车TM2电流
InF本车本车TM3电流=本车本车TM3电流
InF本车本车TM4电流=本车本车TM4电流
InF本车本车TM5电流=本车本车TM5电流
InF本车本车TM6电流=本车本车TM6电流
InF本车本车电流分配=本车本车电流分配
InF本车本车TM1转速=本车本车TM1转速
InF本车本车TM2转速=本车本车TM2转速
InF本车本车TM3转速=本车本车TM3转速
InF本车本车TM4转速=本车本车TM4转速
InF本车本车TM5转速=本车本车TM5转速
InF本车本车TM6转速=本车本车TM6转速
InF本车本车电机转速差=本车本车电机转速差
InF本车本车前增压器转速=本车本车前增压器转速
InF本车本车后增压器转速=本车本车后增压器转速
InF本车本车前冷却风扇转速=本车本车前冷却风扇转速
InF本车本车后冷却风扇转速=本车本车后冷却风扇转速
InF本车本车前增压力=本车本车前增压力
InF本车本车后增压力=本车本车后增压力
InF本车本车滤清器进口压力=本车本车滤清器进口压力
InF本车本车机油进口压力=本车本车机油进口压力
InF本车本车燃油末端压力=本车本车燃油末端压力
InF本车本车高温进口水温=本车本车高温进口水温
InF本车本车高温出口水温=本车本车高温出口水温
InF本车本车机油出口温度=本车本车机油出口温度
InF本车本车励磁机励磁电流=本车本车励磁机励磁电流
InF本车本车主发励磁电流=本车本车主发励磁电流
InF本车本车接地漏电流=本车本车接地漏电流
InF本车本车机车速度=本车本车机车速度
InF本车本车高温水温=本车本车高温水温
InF本车本车机油温度=本车本车机油温度
InF本车本车机油出口压力=本车本车机油出口压力
InF他车他车主电流表=他车他车主电流表
InF他车他车控制电压=他车他车控制电压
InF他车他车柴转速=他车他车柴转速
InF他车他车主电压=他车他车主电压
InF他车他车主电流=他车他车主电流
InF他车他车功率=他车他车功率
InF他车他车TM1电流=他车他车TM1电流
InF他车他车TM2电流=他车他车TM2电流
InF他车他车TM3电流=他车他车TM3电流
InF他车他车TM4电流=他车他车TM4电流
InF他车他车TM5电流=他车他车TM5电流
InF他车他车TM6电流=他车他车TM6电流
InF他车他车电流分配=他车他车电流分配
InF他车他车TM1转速=他车他车TM1转速
InF他车他车TM2转速=他车他车TM2转速
InF他车他车TM3转速=他车他车TM3转速
InF他车他车TM4转速=他车他车TM4转速
InF他车他车TM5转速=他车他车TM5转速
InF他车他车TM6转速=他车他车TM6转速
InF他车他车电机转速差=他车他车电机转速差
InF他车他车前增压器转速=他车他车前增压器转速
InF他车他车后增压器转速=他车他车后增压器转速
InF他车他车前冷却风扇转速=他车他车前冷却风扇转速
InF他车他车后冷却风扇转速=他车他车后冷却风扇转速
InF他车他车前增压力=他车他车前增压力
InF他车他车后增压力=他车他车后增压力
InF他车他车滤清器进口压力=他车他车滤清器进口压力
InF他车他车机油进口压力=他车他车机油进口压力
InF他车他车燃油末端压力=他车他车燃油末端压力
InF他车他车高温进口水温=他车他车高温进口水温
InF他车他车高温出口水温=他车他车高温出口水温
InF他车他车机油出口温度=他车他车机油出口温度
InF他车他车励磁机励磁电流=他车他车励磁机励磁电流
InF他车他车主发励磁电流=他车他车主发励磁电流
InF他车他车接地漏电流=他车他车接地漏电流
InF他车他车机车速度=他车他车机车速度
InF他车他车高温水温=他车他车高温水温
InF他车他车机油温度=他车他车机油温度
InF他车他车机油出口压力=他车他车机油出口压力
InF本车控制电压修正系数=本车控制电压修正系数
InF控制电压过压值=控制电压过压值
InF控制电压欠压值=控制电压欠压值
InF空压机工作时间=空压机工作时间
