目标距离=目标距离
列车运行速度=列车运行速度
列车限制速度=列车限制速度
列车推荐速度=列车推荐速度
列车目标速度=列车目标速度
列车报警速度=列车报警速度
列车紧急速度=列车紧急速度
控制模式=控制模式
运行等级=运行等级
制动状态=制动状态
CBTC连接状态=CBTC连接状态
下一站=下一站
终点站=终点站
工况=工况
最高可用模式=最高可用模式
车首OBCU=车首OBCU
车尾OBCU=车尾OBCU
进入折返区域=进入折返区域
左车门允许=左车门允许
右车门允许=右车门允许
左侧屏蔽门允许=左侧屏蔽门允许
右侧屏蔽门允许=右侧屏蔽门允许
左侧车门状态=左侧车门状态
右侧车门状态=右侧车门状态
左侧屏蔽门状态=左侧屏蔽门状态
右侧屏蔽门状态=右侧屏蔽门状态
停车状态=停车状态
速度指示=速度指示
空转指示=空转指示
门控模式=门控模式
子系统故障=子系统故障
车站控车状态=车站控车状态
停站时间=停站时间
发车状态=发车状态
运行方向=运行方向
司机号字母=司机号字母
司机号=司机号
车次号字母=车次号字母
车次号=车次号
编组=编组
目的地号字母=目的地号字母
目的地号=目的地号
VOBC状态=VOBC状态
ATO允许状态=ATO允许状态
ATP允许状态=ATP允许状态
IATO允许状态=IATO允许状态
IATP允许状态=IATP允许状态
当前站=当前站
离站时间=离站时间
后备模式=后备模式
ATC请求状态=ATC请求状态
下一停车点类型=下一停车点类型
列车下一区段所在区域=列车下一区段所在区域
列车前一区段所在区域=列车前一区段所在区域
列车当前所在区域=列车当前所在区域
控车类型=控车类型
机车信号码=机车信号码
前方信号机状态=前方信号机状态
列车长度=列车长度
服务号=服务号
ATP当前限速=ATP当前限速
切除牵引速度=切除牵引速度
RM允许状态=RM允许状态
移动授权=移动授权
车辆实时运行工况=车辆实时运行工况
显示的日期=显示的日期
显示的时间=显示的时间

