目标距离=目标距离
前方信号机距离=前方信号机距离
进路预选区终点距离=进路预选区终点距离
前车距离=前车距离
后车距离=后车距离
列车运行速度=列车运行速度
列车限制速度=列车限制速度
列车推荐速度=列车推荐速度
列车目标速度=列车目标速度
列车报警速度=列车报警速度
ATP当前限速=ATP当前限速
切除牵引速度=切除牵引速度
列车紧急速度=列车紧急速度
移动授权=移动授权
距前车运行时分=距前车运行时分
距后车运行时分=距后车运行时分
信号制动状态=信号制动状态
CBTC连接状态=CBTC连接状态
下一站=下一站
当前站=当前站
终点站=终点站
车首OBCU=车首OBCU
车尾OBCU=车尾OBCU
左车门允许=左车门允许
右车门允许=右车门允许
左侧车门状态=左侧车门状态
右侧车门状态=右侧车门状态
停车状态=停车状态
速度指示=速度指示
空转指示=空转指示
车站控车状态=车站控车状态
折返信息=折返信息
ATP保护控制=ATP保护控制
ATP启动状态=ATP启动状态
信标状态=信标状态
列车早晚点=列车早晚点
车载运行模式=车载运行模式
发车时间=发车时间
到达时间=到达时间
列车号=列车号
路径号=路径号
线路号=线路号
单程号=单程号
ATP状态=ATP状态
ELS状态=ELS状态
RR状态=RR状态
CP状态=CP状态
VOBC车载主机状态=VOBC车载主机状态
车载定位状态=车载定位状态
车载系统与调度中心通信状态=车载系统与调度中心通信状态
GPS工作状态=GPS工作状态
停站时间=停站时间
发车状态=发车状态
运行方向=运行方向
司机号字母=司机号字母
司机号=司机号
车次号字母=车次号字母
车次号=车次号
编组=编组
目的地号字母=目的地号字母
目的地号=目的地号
列车下一区段所在区域=列车下一区段所在区域
列车前一区段所在区域=列车前一区段所在区域
列车当前所在区域=列车当前所在区域
控车类型=控车类型
机车信号码=机车信号码
前方信号机状态=前方信号机状态
列车长度=列车长度
服务号=服务号
车辆实时运行工况=车辆实时运行工况
系统状态=系统状态
列车回段停车后提示信息=列车回段停车后提示信息
GPS状态=GPS状态
NTC状态=NTC状态
雷达状态=雷达状态
STA状态=STA状态
TOD状态=TOD状态
无线连接状态=无线连接状态
到下一站时间=到下一站时间
下一目标=下一目标
上站到下站偏移量=上站到下站偏移量
障碍物距离1=障碍物距离1
障碍物左右偏移1=障碍物左右偏移1
障碍物距离2=障碍物距离2
障碍物左右偏移2=障碍物左右偏移2
障碍物距离3=障碍物距离3
障碍物左右偏移3=障碍物左右偏移3
显示的日期=显示的日期
显示的时间=显示的时间
